F 100,100,100
C 200,0,80
EA ./textures/purplestone.xpm
NO      ./textures/mossy.xpm
SO ./textures/mossy_square.xpm
WE    ./textures/door.xpm

        1111111111111111111111111
        1000000000110000000000001
        1011000001110000001000001
        1001000000000000000000001
111111111011000001110000000000001
100000000011000001110111111111111
1111011111 111011100000010001
11110111111111011101010010001
11000000110101011100000000001
100010000000E0001100000010001
10000000000000001101010010001
1100000111010101111101111000111
11110111 1110101 101111010001 
11111111 1111111 111111111111
