F 255,120,70
C 200,0,85
R 1400 800  
NO ./textures/north_texture.xpm  
SO ./textures/south_texture.xpm
WE ./textures/west_texture.xpm
EA ./textures/east_texture.xpm
S ./textures/object.xpm




        1111111111111111111111111
        1000000000110000000000001
        1011000001110000002000001
        100100S000000000000000001
111111111011000001110000000000001
100000000011000001110111111111111
11110111111111011100000010001
11110111111111011101010010001
11000000110101011100000000001
10002000000000001100000010001
10000000000000001101010010001
1100000111010101111101111000111
11110111 1110101 101111010001 
11111111 1111111 111111111111
