R 1600 800
EA ./textures/brick.xpm
NO      ./textures/purplestone.xpm
SO ./textures/south_texture.xpm
WE    ./textures/west_texture.xpm
F   255,255,70     
C 255,20,88
11111
10001
1N001
11111
