11111111111
1000000001
1110000001
101000000111111111
111111110000000001
110000000000001111
110000000000001
111111111111111